111111111111111111111111111
1C100000000011000011CCC1101
1011011C011101000010CEC0101
10110010000101000011CCC0001
101100100111010000011000101
1010001P000100000100000C001
1000001001110100C0000000001
100000000000000000000000001
111111111111111111111111111